8 60 LEFT
________
________
________
________
________
________
________
____E__E
________
__E___E_
________
_E_E____
___EE___
____EE__
_____E__
_I_EE___
________
EE______
___E____
___E___E
______EE
_____EE_
____IE__
___E____
__EE____
_EE_____
IE______
________
________
________
EEEEEEEE
EEEEIEEE
________
_______E
______E_
________
EE__EE__
EEEEEEEE
__EE__IE
________
________
________
E______E
EE____EE
_EE__EE_
__EEEE__
________
________
________
________
________
________
________
________
________
________
________
________
________
_______I
