8 60 LEFT
EEEEEEEE
E______E
E_EEEE_E
E______E
E______E
E______E
E______E
E______E
E______E
E______E
EIE____E
E______E
E______E
EE___E_E
E__EE__E
EEEEEEEE
_I______
__I_____
_____EEE
_IE_____
________
_I______
________
________
_E___E__
________
___EE___
________
__I_____
_____EEE
EEEEEEEE
E______E
E_EEEE_E
E______E
E______E
E______E
E______E
E______E
E______E
E______E
EIE____E
E______E
E______E
EE___E_E
E__EE__E
EEEEEEEE
_I______
__I_____
_____EEE
_IE_____
________
_I______
________
________
_E___E__
________
___EE___
________
__I_____
_____EEE