8 240 LEFT
________
________
________
________
________
________
________
________
________
________
________
________
________
________
________
________
________
________
________
________
________
____EEEE
________
__EEEEEE
________
________
________
________
________
EEEE____
________
EEEEEE__
________
________
________
________
________
________
________
________
________
________
________
________
________
________
________
________
EEEEEEEE
________
________
EEEEEEEE
________
________
EEEEEEEE
________
________
EEEEEEEE
________
________
EEEEEEEE
________
________
________
________
________
________
________
________
________
________
________
________
________
________
________
________
IIIIIIII
IIIIIIII
EEEEEEEE
EEEEEEEE
EEEEEEEE
EEEEEEEE
EEEEEEEE
EEEEEEEE
EEEEEEEE
EEEEEEEE
EEEEEEEE
EEEEEEEE
EEEEEEEE
EEEEEEEE
EEEEEEEE
EEEEEEEE
EEEEEEEE
EEEEEEEE
________
________
________
________
________
________
________
CCEEEEEE
___EEEEE
E___EEEE
EE___EEE
EEE___EE
________
________
________
SSSSSSSS
SSSSSSSS
EEEEEEEE
EEEEEEEE
EEEEEEEE
EEEEEEEE
________
________
________
________
________
I_I_I_I_
_I_I_I_I
I_I_I_I_
_I_I_I_I
I_I_I_I_
_I_I_I_I
I_I_I_I_
_I_I_I_I
________