8 663 LEFT
________
________
E__E__E_
________
________
_E__E__E
________
________
__E__E__
_______
________
E___EEEE
________
__EEEEEE
________
__E_____
____E___
______E_
__E_____
_EEE____
________
E_E_E_E_
________
EEEEEEEE
________
________
EEEEEEEE
________
________
EEEEEEEE
________
________
EEEEEEEE
________
________
EEEEEEEE
________
EEEEEEEE
________
________
EEEEEEEE
________
________
EEEEEEEE
________
________
EEEEEEEE
________
________
EEEEEEEE
________
EEEEEEEE
________
EEEEEEEE
________
EEEEEEEE
________
EEEEEEEE
________
________
________
________
________
________
________
________
________
E___E___
_E___E__
__E___E_
___E___E
E___E___
_E___E__
__E___E_
___E___E
E___E___
_E___E__
__E___E_
___E___E
E___E___
_E___E__
__E___E_
___E___E
E___E___
_E___E__
__E___E_
___E___E
E___E___
_E___E__
E_E_E_E_
_E_E_E_E
E_E_E_E_
_E_E_E_E
E_E_E_E_
_E_E_E_E
E_E_E_E_
_E_E_E_E
E_E_E_E_
_E_E_E_E
________
________
________
________
________
________
________
________
________
________
________
________